%%%%%%%%%%%%%%
%           P%
%        %%% % 
%         %  %
%%          %%
%.        %%%%
%%%%%%%%%%%%%%